+-------------------+
|                   |
|     S       @     |
|          O        |
| S O    O  O    @  |
|      O     O      |
|  S       OO       |
|      O  O     @   |
|                   |
|   OOOO            |
|     O         OOOO|
|   O  O   M   O    |
|   OOO O    O      |
|        O O        |
|         O        O|
+-------------------+
